#####
# $. #
#    #
# @ $#
#####
;
########
#  .  ##
# ^  @ #
#  $   #
#      #
########
;
 #######
 #..  ##
 ##   ##
###$  ##
### $ ##
# @   ##
########
;
##########
## .    #
## $$$   #
###@# #$ ##
###..  .#
#########