#####
# $. #
#    #
# @ $#
#####
;
########
#  .  ##
# ^  & #
#  $   #
#      #
########